111111111111111
1E0000000000011
1PCC1CCC00000C1
111111111111111