1111111111111111111111111111111111
1101000000000000C00100C000000000001
111110010100100000101001100000010101
111110010100100000101001100000010101
111110010100100000101001100000010101
1111111111001010010000E101001100000010101
111111110010100100000101001100000010101
1110010100100000101001100000010101
1111110010100100000101001100000010101
1110010100100000101001100000010101
1110010100100000101001100000010101
1110010100100000101001100000010101
1110010100100000101001100000010101
1110010100100000101001100000010101
1110010100100000101001100000010101
1110010100100000101001100000010101
1110010100100000101001100000010101
1010010010101010001000110000010101
1P0000000C00C0000000001000000000C1
1111111111111111111111111111111111