111111111111111
1E0000000000001
1PCCCCCC00000C1
111111111111111