1111111111111111
1E000000C0000001
1100010010010101
1100011010010101
1P00000C000000C1
1111111111111111